BBBBBBBBBBBBBBBBBBBBBBBBBBBBBBBBBBBBBBBBBBBBBBBBBBBBBBBBBBBBBBBBBBB
B                                                                 B
B                                                                 B
B                                                                 B
B                                                                 B
B                                                                 B
B                                                                 B
B                                                                 B
B                                                                 B
B                                                                 B
B                                                                 B
B                                                                 B
B                                                                 B
B                                                                 B
BP            J                Y                   F              B
BBBBBBBBBBBBBBBBBBBBBBBBBBBBBBBBBBBBBBBBBBBBBBBBBBBBBBBBBBBBBBBBBBB