BBBBBBBBBBBBBBBBBBBBBBBBBBBBBBBBBBBBBBBBBBBBBBBBBBBBBBBBBBBBBBBBBBBBBBBBBBBBBBBBBBBBBBBBB
B                                                                                       B
B                                                                                       B
B                                                                                       B
B                                                                                       B
B                                                                                       B
B                                                                                       B
B                                                                                       B
B                                                                                       B
B                                                                                       B
B                                                                                       B
B                                                                                       B
B                                                                                       B
B                                                                                       B
BP            J                Y                                         F              B
BBBBBBBBBBBBBBBBBBBBBBBBBBBBBBBBBBBBBBBBBBBBBBBBBBBBBBBBBBBBBBBBBBBBBBBBBBBBBBBBBBBBBBBBB