BBBBBBBBBBBBBBBBBBBBBBBBBBBBBBBBBBBBBBBB
B                  B                   B
B                  B                   B
B                  B                   B
B                  B                   B
B                  B                   B
B                  BB               Y  B
B                   BBBBBB     BBDDBBBBB
B                                      B
B                  BBBBBBBB LBBBBBBBBB B
BB                 BBBBBBBB  BBBBBBBBB B
B                  BBBBBBBB  BBBBBBBBB B
B                  BBBBBBBBR BBBBBBBBB B
B                  BBBBBB      BBBBBBB B
B        BBBBBBBBBBBBBBBB      BBBBBBB B
B   B              BBBBBB      BBBBBBB B
B                             EBBBBBBB B
BC           BBBBBBBBBBBBBBBBBBBBBBBBB B
B      U    B      BBBBBBBBBBBBBBBBBBB B
B     BB           BBBBBBBBBBBBBBBBBBB B
B                                      B
B   B  B       B  BBBB                 B
B      B       B BBBBBB                B
B      B       B BBBBBBB    B     B    B
BP          J                  F       B
BBBBB  BBBBBBBBB BBBBBBBBBBBBBBBBBBBB  B